_____________________
╬                   ╬
╬ ╬═╬═╬═╬═╬═╬═╬═╬═╬ ╬
╬ ╬ ╬ ╬ ╬   ╬       ╬
╬ ╬ ╬═╬ ╬═╬ ╬ ╬ ╬ ╬═╬
╬   ╬   ╬   ╬     ╬X╬
╬═╬ ╬═╬ ╬═╬ ╬ ╬ ╬ ╬ ╬
╬   ╬ ╬       ╬   ╬ ╬
╬═╬═╬ ╬═╬ ╬ ╬ ╬═╬ ╬ ╬
╬     ╬       ╬   ╬ ╬
╬ ╬═╬ ╬═╬ ╬═╬ ╬ ╬ ╬ ╬
╬   ╬ ╬   ╬   ╬   ╬ ╬
╬═╬═╬ ╬ ╬ ╬═╬═╬ ╬═╬ ╬
╬     ╬     ╬   ╬   ╬
╬ ╬═╬═╬ ╬═╬ ╬ ╬═╬ ╬═╬
╬ ╬   ╬     ╬   ╬ ╬ ╬
╬ ╬ ╬ ╬ ╬═╬═╬═╬ ╬ ╬═╬
╬ ╬ ╬       ╬     ╬ ╬
╬ ╬ ╬ ╬═╬═╬ ╬ ╬═╬═╬═╬
╬@  ╬     ╬   ╬ ╬   ╬
‾‾‾‾‾‾‾‾‾‾‾‾‾‾‾‾‾‾‾‾‾
